1111111111
100000C001
10010O0001
1E000C0P01
1000000001
1111111111
