11111111111
100C000P001
10000000001
10C00000C01
10000000001
1110000C001
10E00000001
11111111111
