1111111111111
100C0000P0001
1010000000001
10C1000010C01
1000000010001
1110000C00011
10E00000000C1
1111111111111
