1111111111
10C0001C01
1O01110001
100C000011
1100000P01
1E0C000111
1111111111
