1111111111
10C0000C01
1001110001
100C000011
1100000P01
1E0C0O0001
1111111111
